dissemination - spreading
immensely - чрезвычайно/очень
issue - выпуск (журнала, комикса и т.п.)
conceal - таить
grasp - понять/осознать/схватывать
extrapolate - generalize; обобщить/спроецировать на
affable - приветливый
prejudice - предубеждение
(someones) perspective - (someones) viewpoint
intimacy - интимность (возможно фамильярность)
bias - предубеждение в пользу/во вред кому-то обычно нечестное
ostracism - остракизм; изгнание
innocuous - безвредный
exert (something) - вызывать/оказать
to yearn - тосковать
nudge - толчок
exacerbate - усугубить
explicit - явный/точный
ubiquity - вездесущность
credibility - правдоподобность
dwindle - diminish gradually in size, amount, or strength; значительно истощаться, сокращаться
insomnia - бессонница
adequate - ну давай, догадайся
essence, entity - сущность
negotiate - вести переговоры, преодолевать
enhance - усилить
testimonial - отзыв
testimony - Evidence or proof provided by the existence or appearance of something
namely - а именно
absenteeism - the practice of regularly staying away from work or school without good reason
plunge - погружать
drawn from - взяты из
unearth - откопать (довольно интуитивно но странно)
to recede - отступать
to attribute - приписывать
surge - волна
therapeutic - терапевтический
rashes - высыпания
wrinkles - морщины
complexion - цвет + структура лица, кожи
facial - beauty treatment for the face; массаж лица
sagging - повисшие (губы например)
firm - твердый, статичный, устойчивый
trout - форель
pout - вздуть губы от недовольства
freckles - веснушки
blotch - пятно (родимое например)
deteriorating - ухудшается
humble - смиренный, покорный
keel over - свалиться/шлепнуться/опрокинуться/неожиданно упасть
juniper - можжевельник
rubble - щебень
delusion - заблуждение (delusional - бредовый)
prescription - "Brushed by you at the bar, didn't match your description; It soon became my prescription" from red planet by alvvays
feat - подвиг
relish - pleasurable appreciation of anything; liking
grimy - covered with grime; dirty
grime - грязь
hub - a center around which other things revolve or from which they radiate; a focus of activity, authority, commerce, transportation, etc
vagabonding - wandering from place to place without any settled home; nomadic
nomad - кочевник
cab - taxi
fete - celebration (чествовать)
upheaval - переворот
buoyancy - плавучесть
grass-roots - wide masses
fertilize - удобрять
fertile - плодородный
ground, soil - грунт
tenant - арендатор
designs - plans
refurbishment - переоборудование, переоснащение
reluctant - unwilling
on the contrary - on the other hand
ethos - этос
bustling - суетливый
quaint - причудливый
picturesque - живописный
lush - пышный
sprawling - растянувшийся, раскинувшийся
drought - засуха
wasteland - пустошь
haphazard - бессистемный, беспорядочный
barren - бесплодный, пустынный, безжизненный
rugged - грубый, шершавый
vibrant - полный жизни, живой. Буквально - вибрирующий, трепещущий
to reminisce - вспоминать, предаваться воспоминаниям. Не путать с recall - вспомнить
to recount - (в разговоре, вслух) вспоминать, рассказывать
vicinity - окрестность, округа, район
fare - еда (local fare - местная кухня). Чаще используется в смысле "стоимость"
juxtaposing - сравнение
landmark - достопримечательность, ориентир
to erode - разрушаться
setback - a difficulty or problem that delays or prevents something, or makes a situation worse
painstaking - done with or employing great care and thoroughness
vain - unsuccessful or useless (attempt to save someone for example)
vanity - excessive belief in one's own abilities or attractiveness to others
stratagem - an artifice or trick in war for deceiving and outwitting the enemy
bewildered - very puzzled
acquaint - знакомить кого-то с кем-то (I acquainted George with Sam)
linger - to remain or stay on in a place longer than is usual or expected
compulsion - принуждение, понуждение
to be loath to part with smth - жалеть расстаться с чем-то
tainted - испорченный, грязный (You think all my money is tainted?)
fraught - чревато
sabbatical leave - академический отпуск
immaculate - безупречный
dispelled - рассеянный (как в доте - to dispel)
dismantled - разобранный, демонтированный, ликвидированный
depleted - истощённый, исчерпанный
to stagger - шататься
to fidget - ёрзать, вертеться, суетиться (отсюда же fidget spinner)
to jostle - толкаться, тесниться
scarce - дефицитный, скудный
deficient - неполноценный, недостаточный, неполный
backlog - отставание, долг
to detract - умалять, отвлекать от (from smth)
to deceive - вводить в заблуждение, обманывать
to deter - удерживать, сдерживать
to impose - наложить (to impose ban on knives)
compelled - вынужденный
jeopardy - опасность
discrepancy - несоответствие, несовпадение, несходство
to desolate - опустошать
to ravage  - опустошать, разорять, бушевать, свирепствовать
free rein - свобода действий
repercussions - последствия
superset - надмножество
callus - corn, blister, bunion, мозоль (даже не знаю какое слово выбрать)
tantamount - as good as, more or less
treason - the crime of betraying one's country
contemplate - look thoughtfully for a long time at smth; think deeply and at length
hinder - to make it difficult for (someone) to do something or for (something) to happen
obstruction - block (an opening, path, road, etc.); be or get in the way of
impediment - a hindrance or obstruction in doing something: "a serious impediment to scientific progress"
aversion - a strong dislike or disinclination
disinclination - a reluctance or lack of enthusiasm
freedman - an emancipated slave
readiness - the state of being fully prepared for something: "muscles tense in readiness for action"
exile - изгнание, ссылка
banishment - изгнание, ссылка: "Adam and Eve's banishment from the Garden of Eden"
contentment - a state of happiness and satisfaction
folly - lack of good sense; foolishness
sheer - nothing other than; unmitigated (used for emphasis)
mitigation - the action of reducing the severity, seriousness, or painfulness of something
condemned - sentenced to a particular punishment, especially death
emendation - the process of making a revision or correction to smth (text, verdict)
privy - hidden, secret
allegiance - loyalty or commitment to a superior or to a group
rudder - руль лодки (подвижный "плавник" сзади), такой же есть у самолета
pigeonhole - "people identified me with a homely farmer's wife and I could never escape that pigeonhole"
chime - a melodious ringing sound, as produced by striking a bell
jingle - a light ringing sound such as that made by metal objects being shaken together
rigour - the quality of being extremely thorough and careful
rigorously - неочевидное преобразование корня вышеупомянутого слова
fidelity - the degree of exactness with which something is copied or reproduced
inherent - свойственный
virtue - добродетель, достоинство, преимущество, достоинство
elusive - неуловимый
flourishing - цветущий, процветающий, успешный
cubicle - кабинка
incessant - (of something regarded as unpleasant) continuing without pause or interruption
to encroach - intrude on (a person's territory, rights, personal life, etc.).
nagging - persistently painful or worrying.
superficial - поверхностный (знание, урон здоровью)
futile - incapable of producing any useful result
sentiment - a view or opinion that is held or expressed
to devise - plan or invent (a complex procedure, system, or mechanism) by careful thought
thicket - a dense group of bushes or trees
lest (conjunction) - With the intention of preventing (something undesirable);
    to avoid the risk of
    "he spent whole days in his room, headphones on lest he disturb anyone"
verbiage - excessively lengthy or technical speech or writing
succinctly /səkˈsɪŋ(k)tli/ - in a brief and clearly expressed manner
adherent (noun) - someone who supports a particular party, person, or set of ideas
to evince - reveal the presence of (a quality or feeling); indicate
secluded - (of a place) not seen or visited by many people; sheltered and private
endeavour - earnest, prolonged, and industrious effort
to exult - feel or show triumphant elation or jubilation
apex - the top or highest part of something, especially one forming a point
to faze - disturb or disconcert (someone)
disconcert - disturb the composure of; unsettle
binge - a period of excessive indulgence in an activity
to thwart - prevent (someone) from accomplishing something
to mull - think about (a fact, proposal, or request) deeply and at length
idiosyncrasy - a mode of behaviour or way of thought peculiar to an individual
peculiar - different to what is normal or expected; strange
conceive - form or devise (a plan or idea) in the mind
to slog - work hard over a period of time
to hone - refine or perfect (something) over a period of time
lavish - sumptuously rich, elaborate, or luxurious
trepidation - a feeling of fear or anxiety about something that may happen
facade (metaphorically) - a deceptive outward appearance
euphemism - an innocuous word or expression used in place of one that may be found offensive or suggest something unpleasant
lascivious - feeling or revealing an overt sexual interest or desire
    (похотливый)
poignant - evoking a keen sense of sadness or regret
musing - a period of reflection or thought
inconspicuous - not clearly visible or attracting attention
anguish (noun) - severe mental or physical pain or suffering
        (verb) - be extremely distressed about something
fragile - (of an object) easily broken or damaged
profound - great depth or intensity of a state, quality, or emotion (глубокий)
abstruse - difficult to understand; obscure
subtle - (especially of a change or distinction) so delicate or precise as to be difficult to analyse or describe
dilapidated - (of a building or object) in a state of disrepair or ruin as a result of age or neglect
overwrought - in a state of nervous excitement or anxiety
lacklustre - lacking in vitality, force, or conviction; uninspired or uninspiring
scoff (verb) - speak to someone or about something in a scornfully derisive or mocking way
scornful - feeling or expressing contempt or derision
contempt - the feeling that a person or a thing is worthless or beneath consideration
derision - contemptuous ridicule or mockery
ridicule - the subjection of someone or something to contemptuous and dismissive language or behaviour
provisional - arranged or existing for the present, possibly to be changed later
recess -  small space created by building part of a wall further back from the
    rest; a hollow space inside something; a remote, secluded, or secret place
subpar - inferior
salvation - Deliverance from sin and its consequences, believed by Christians to
be brought about by faith in Christians
deliverance - The action of being rescued or set free
contemporary - современный (adj) современник (noun)
drudgery - Hard, menial, or dull work ("каторга")
menial - (of work) Not requiring much skill and lacking prestige
consolation - Comfort received by a person after a loss or disappointment
apprehension - Understanding; grasp
err (verb) - Be mistaken or incorrect; make a mistake
reel - A cylinder on which film, wire, thread, or other flexible materials can
    be wound (бобина)
to reel - Wind a line on to a reel by turning the reel (наматывать)
inquiry - An act of asking for information
novel - New or unusual in an interesting way
harp - Talk or write persistently and tediously on a particular topic
tedious - Too long, slow, or dull: tiresome or monotonous
complacent - Showing smug or uncritical satisfaction with oneself or one's achievements
revelation - A surprising and previously unknown fact, esp. one that is made
    known in a dramatic way
harbor (verb) - Keep (a thought or feeling, typically a negative one) in one's mind, esp. secretly
       (noun) - A place on the coast where vessels may find shelter, esp. one
       protected from rough water by piers, jetties, and other artificial
       structures; A place of refuge
defer (verb) - Submit humbly to (a person or a person's wishes or qualities)
admonish (verb) - Warn or reprimand someone firmly
reprimand - Rebuke (someone), esp. officially
rebuke (verb) - Express sharp disapproval or criticism of (someone) because of
    their behavior or actions
esp. (abbreviation) - especially
seldom (adjective) - Not common; infrequent
       (adverb) - Not often; rarely
portmanteau - a new word formed by joining two others and combining their
    meanings; "`smog' is a blend of `smoke' and `fog'"; "`motel' is a
    portmanteau word made by combining `motor' and `hotel'"; "`brunch' is a
    well-known portmanteau"
predicament (noun) - A difficult, unpleasant, or embarrassing situation
imminent (adjective) - About to happen
leisure - досуг
persuade (verb) - Cause (someone) to do something through reasoning or argument
warder - A guard in a prison
reprisal - An act of retaliation
retaliation - The action of harming someone because they have harmed oneself;
    revenge (возмездие)
intrinsic (adj) - Belonging naturally; essential
gratitude - The quality of being thankful; readiness to show appreciation for
    and to return kindness
stipulate (verb) - Demand or specify (a requirement), typically as part of a
    bargain or agreement
inanimate (adj) - Showing no sign of life; lifeless
avow (verb) - Assert or confess openly
juror - A member of a jury
deprecatory - Expressing disapproval; disapproving
perennial - Lasting or existing for a long or apparently infinite time; enduring
incure - Become subject to (something unwelcome or unpleasant) as a result of
    one's own behavior or actions
elicit - Evoke or draw out (a response, answer, or fact) from someone in
    reaction to one's own actions or questions
infer - Deduce or conclude (information) from evidence and reasoning rather than
    from explicit statements
palatable - (of food or drink) Pleasant to taste
ingenious - (of a person) Clever, original, and inventive
compatriot - A fellow citizen or national of a country
bishop - A senior member of the Christian clergy, typically in charge of a
    diocese and empowered to confer holy orders
refute (verb) - Prove (a statement or theory) to be wrong or false; disprove
customary (adj) - Commonly practiced, used, or encountered; usual. synonym: usual
fraudulent - Engaging in fraud; deceitful
bogus (adj) - Counterfeit or fake; not genuine
counterfeit (adj) - Made in exact imitation of something valuable or important
    with the intention to deceive or defraud
subvert (verb) - Undermine the power and authority of (an established system or institution)
undermine - Dig or excavate beneath (a building or fortification) so as to make
    it collapse; this is often used in metaphorical sense
bona fide (latin) - Made or carried out in good faith; sincere
mischief - Playful misbehavior or troublemaking, esp. in children
gullible - Easily persuaded to believe something; credulous
credulous - Having or showing too great a readiness to believe things
underpin (verb) - Support, justify, or form the basis for
seize - Take hold of suddenly and forcibly
formidable - Inspiring fear or respect through being impressively large,
    powerful, intense, or capable
trawl (verb) - Fish with a trawl net or seine
      (noun) - a type of fishing net
seine - A fishing net that hangs vertically in the water with floats at the top
    and weights at the bottom edge, the ends being drawn together to encircle the
    fish
contrary - Opposite in nature, direction, or meaning
dispute (verb) - Argue about (something); discuss heatedly
        (noun) - same
preempt - Take action in order to prevent (an anticipated event) from happening;
    forestall
bedevil - of something bad) Cause great and continual trouble to
courteous (adj) - Polite, respectful, or considerate in manner
strive (verb) - Make great efforts to achieve or obtain something
suffice (verb) - Be enough or adequate (хватит)
afield (adverb) - To or at a distance
graft (noun) - Hard work
      (verb) - Work hard
tip-off (noun) - A piece of information, typically one given in a discreet or
    confidential way
omission (noun) - Someone or something that has been left out or excluded
treatise (noun) - A written work dealing formally and systematically with a subject
perverse (adj) - (of a person or their actions) Showing a deliberate and
    obstinate desire to behave in a way that is unreasonable or unacceptable, often
    in spite of the consequences
obstinate (adj) - (of a person or their actions) Showing a deliberate and
    obstinate desire to behave in a way that is unreasonable or unacceptable, often
    in spite of the consequences
insinuate - Suggest or hint (something bad or reprehensible) in an indirect and
    unpleasant way
reprehend - reprimand :)
decry (verb) - Publicly denounce
denounce - Publicly declare to be wrong or evil
grief - Deep sorrow, especially that caused by someone's death
pretension - A claim or the assertion of a claim to something
perceive - Become aware or conscious of (something); come to realize or understand
earnest - Resulting from or showing sincere and intense conviction
eminent - (of a person) Famous and respected within a particular sphere or profession
disgrace - Loss of reputation or respect, esp. as the result of a dishonorable
    action
rabble - A disorderly crowd; a mob
clamour - loud and persistent outcry from many people
momentous - (of a decision, event, or change) Of great importance or
    significance, esp. in its bearing on the future
eloquent (adj) - Fluent or persuasive speaking or writing
fluent - (of a person) Able to express oneself easily and articulately
bustle - (of a place) Be full of activity
proselyte - A person who has converted from one opinion, religion, or party to
    another, esp. recently
boast (verb) - Talk with excessive pride and self-satisfaction about one's
    achievements, possessions, or abilities
inadvertently - Without intention; accidentally
vex (verb) - Make (someone) feel annoyed, frustrated, or worried, esp. with trivial matters
afflict (verb) - (of a problem or illness) Cause pain or suffering to; affect or trouble
trifecta - A run of three wins or grand events
construe - Interpret (a word or action) in a particular way
demarcate - Set the boundaries or limits of
arcane - Understood by few; mysterious or secret
burble (verb) - Make a continuous murmuring noise
murmuring (noun) - A soft, low, or indistinct sound produced by a person or
    group of people speaking quietly or at a distance
profess - Claim openly but often falsely that one has (a quality or feeling)
comprehend - Grasp mentally; understand
indolence - Avoidance of activity or exertion; laziness
utmost - Most extreme; greatest
esteem - Respect and admire; Consider; deem
cognizance - Knowledge, awareness, or notice
disposition - An inclination or tendency
expedient - (of an action) Convenient and practical, although possibly improper or immoral
hitherto (adverb) - Until now or until the point in time under discussion
conquest - The subjugation and assumption of control of a place or people by use of military force
subjugate - Bring under domination or control, esp. by conquest
comprised (of) - Consist of; be made up of
grudgingly - In a reluctant or resentful manner
resentful - Feeling or expressing bitterness or indignation at having been treated unfairly
indignation - Anger or annoyance provoked by what is perceived as unfair treatment
leeway - The amount of freedom to move or act that is available
    "there is little leeway if anything goes wrong"
apparent - Clearly visible or understood; obvious
notwithstanding (preposition, conjunction, adverb) - In spite of
susceptible - Likely or liable to be influenced or harmed by a particular thing
liable - Responsible by law; legally answerable
    "the supplier of goods or services can become liable for breach of contract
    in a variety of ways"
chimeric - (of a mythical animal) formed from parts of various animals
earnest - Resulting from or showing sincere and intense conviction
conviction - A firmly held belief or opinion; OR A formal declaration that
    someone is guilty of a criminal offense
contend - Struggle to surmount (a difficulty or danger)
surmount - Overcome (a difficulty or obstacle)
prudent - Acting with or showing care and thought for the future
venture (verb) - Dare to do something or go somewhere that may be dangerous or unpleasant
    "she ventured out into the blizzard"
        (noun) - A risky or daring journey or undertaking
affirm - State as a fact; assert strongly and publicly
artisan - A worker in a skilled trade, esp. one that involves making things by hand
premeditation - The action of planning something (esp. a crime) beforehand
glean - Extract (information) from various sources; Collect gradually and bit by
    bit; Gather (leftover grain or other produce) after a harvest
judicious - Having, showing, or done with good judgment or sense
fond (of) (adj) - Having an affection or liking for
endearing - Inspiring love or affection
concoct - Make (a dish or meal) by combining various ingredients
belated - Coming or happening later than should have been the case
discourse (noun) - Written or spoken communication or debate; A formal
    discussion of a topic in speech or writing;
scruple (verb) - Hesitate or be reluctant to do something that one thinks may be wrong
        (noun) - the same thing
vivacity - (esp. in a woman) The quality of being attractively lively and animated
shew - an archaic spelling of show
conjunction - The act of joining or the condition of being joined
scarlet - Of a brilliant red color
convey - Make (an idea, impression, or feeling) known or understandable to
    someone; Communicate (a message or information)
travesty - A false, absurd, or distorted representation of something
wanton (adj) - (of a cruel or violent action) Deliberate and unprovoked
wanting (adj) - Lacking in a certain required or necessary quality; absent
maxim - A short, pithy statement expressing a general truth or rule of conduct
pithy - (of language or style) Concise and forcefully expressive
merit (verb) - Deserve or be worthy of (something, esp. reward, punishment, or attention)
    "the results have been encouraging enough to merit further investigation"
amiss (adj) - Not quite right; inappropriate or out of place
    "there was something amiss about his calculations"
mediately - посредственно?
despise - Feel contempt or a deep repugnance for
repugnance - Intense disgust
innate - Inborn; natural; Originating in the mind
render (verb) - Provide or give (a service, help, etc.)
    "Mrs. Evans would render assistance to those she thought were in real need"
entail - Involve (something) as a necessary or inevitable part or consequence
antecedent (adj) - Preceding in time or order; previous or preexisting
           (noun) - A thing or event that existed before or logically precedes another
posterior (adj) - Further back in position; of or nearer the rear or hind end,
    esp. of the body or a part of it
rear (adj) - At the back
dishearten - Cause (someone) to lose determination or confidence
    "the farmer was disheartened by the damage to his crops"
kvetch (verb) - Complain
gauge - Estimate or determine the magnitude, amount, or volume of
    "astronomers can gauge the star's intrinsic brightness"
ramification - A consequence of an action or event, esp. when complex or unwelcome
    "any change is bound to have legal ramifications"
languid - (of a person, manner, or gesture) Displaying or having a
    disinclination for physical exertion or effort; slow and relaxed
    "they turned with languid movements from back to front so as to tan evenly"
chief (adj) - Most important
fable (noun) - A short story, typically with animals as characters, conveying a moral
      (verb) - Tell fictitious tales
confound (verb) - Cause surprise or confusion in (someone), esp. by acting
    against their expectations
    "the inflation figure confounded economic analysts"
    Mix up (something) with something else so that the individual elements
    become difficult to distinguish
    "from these three relations we are apt to confound our ideas"
quandary - A state of perplexity or uncertainty over what to do in a difficult situation
halfhearted - Without enthusiasm or energy
contort (verb) - Twist or bend out of its normal shape
rectifier - An electrical device that converts an alternating current into a
    direct one by allowing a current to flow through it in one direction only
accountable - (of a person, organization, or institution) Required or expected
    to justify actions or decisions; responsible
    "parents could be held accountable for their children's actions"
unaccountable - Unable to be explained; (of a person or their behavior)
    Unpredictable and strange
    "a strange and unaccountable fact"
prevail (verb) - Prove more powerful than opposing forces; be victorious
    "it is hard for logic to prevail over emotion"
faculty - An inherent mental or physical power
    "her critical faculties"
viz. (adverb) - Namely; in other words (used esp. to introduce a gloss or explanation)
resemble (verb) - походить
    "The historic Oakfield grounds now resemble a modern-day battlefield"
resemblance - The state of resembling or being alike; сходство
    "they bear some resemblance to Italian figurines"
contiguous - Next or together in sequence; Sharing a common border; touching
fad - An intense and widely shared enthusiasm for something, esp. one that is
    short-lived and without basis in the object's qualities; a craze; прихоть

fancy (verb) - Feel a desire or liking for
                   "do you fancy a drink"
      (adj)  - Elaborate in structure or decoration
                   "fancy furniture"
      (noun) - The faculty of imagination; фантазия, воображение
                   "my research assistant is prone to flights of fancy"
               ...or: A thing that one supposes or imagines, typically an
               unfounded or tentative belief or idea
                   "scientific fads and fancies"
               feeling of liking or attraction, typically one that is
               superficial or transient
custom - A traditional and widely accepted way of behaving or doing something
    that is specific to a particular society, place, or time
        "the old English custom of dancing around the maypole"
    A thing that one does habitually
interpose - Place or insert between one thing and another
subordinate - Lower in rank or position
cohesion - The action or fact of forming a united whole
    "the work at present lacks cohesion"
requisite (adj) - Made necessary by particular circumstances or regulations
    "nothing is more requisite for a true philosopher, than to restrain the
    intemperate desire of searching into causes"
contended - Happy and at ease
incentive (noun) - A thing that motivates or encourages one to do something
designation - The choosing and naming of someone to be the holder of an official position
    "a leader's designation of his own successor"
alas (exclamation) - An expression of grief, pity, or concern
diligent (adj) - Having or showing care and conscientiousness in one's work or duties
conscience - An inner feeling or voice viewed as acting as a guide to the
    rightness or wrongness of one's behavior
gimmick - a trick or device intended to attract attention, publicity, or trade
ruffian - A violent person, esp. one involved in crime
raunchy - Earthy, vulgar, and often sexually explicit
perchance (adverb) - By some chance; perhaps
alumnus - A graduate or former student, esp. male, of a particular school, college, or university
apprentice - A person who is learning a trade from a skilled employer, having
    agreed to work for a fixed period at low wages
revere (verb) - Feel deep respect or admiration for (something)
propensity - An inclination or natural tendency to behave in a particular way
fierce (adj) - Having or displaying an intense or ferocious aggressiveness
ferocious - Savagely fierce, cruel, or violent
efface (verb) - Make oneself appear insignificant or inconspicuous
partake (verb) - join in (an activity)
carnage (verb) - the killing of a large number of people
bulletin - бюлетень; A short official statement or broadcast summary of news; A
    regular newsletter or printed report issued by an organization or society
extol (verb) - praise enthusiastically
meddle - Interfere in or busy oneself unduly with something that is not one's concern
    "I don't want him meddling in our affairs"
unduly - to an undue degree
undue - Unwarranted or inappropriate because excessive or disproportionate
due (adj) - Expected at or planned for at a certain time
            "talks are due to adjourn tomorrow"
            (of a payment) Required at a certain time
            "the May installment was due"
            (of a person) Having reached a point where the thing mentioned is
            required or owed
            "she was due for a raise"
            (of a thing) Required or owed as a legal or moral obligation
            "he was only taking back what was due to him"
            Of the proper quality or extent; adequate
            "driving without due care and attention"
    (noun) - A person's right; what is owed to someone
             "he attracts more criticism than is his due"
             An obligatory payment; a fee
             "he had paid trade union dues for years"
inductee - a person inducted into an organization or social group
preclude - Prevent from happening; make impossible
blather - Talk long-windedly without making very much sense
ostensible - Stated or appearing to be true, but not necessarily so
frolic (adj) - Cheerful, merry, or playful
       (verb) - Play and move about cheerfully, excitedly, or energetically
       (noun) - A playful action or movement
bliss (noun) - Perfect happiness; great joy
veritable - Used as an intensifier, often to qualify a metaphor
    "the early 1970s witnessed a veritable price explosion"
fain (adverb) - With pleasure; gladly
inhere - Exist essentially or permanently in
conception - The forming or devising of a plan or idea
malleable - Easily influenced; pliable
pliable - easily bent; flexible
fusible - Able to be fused or melted easily
soluble - (of a substance) Able to be dissolved, esp. in water
jeer - Make rude and mocking remarks, typically in a loud voice
memo - A written message, esp. in business
reclamaion - the recovery of useful substances from waste products
bravado - A bold manner or a show of boldness intended to impress or intimidate
akin (adj) - of similar character
pique (verb) - Stimulate (interest or curiosity)
albeit (conjunction) - although
wane -  (esp. of a condition or feeling) Decrease in vigor, power, or extent;
    become weaker
annul (verb) -  Declare invalid (an official agreement, decision, or result)
dispensation - Exemption from a rule or usual requirement
exempt - free (a person or organization) from an obigation or liability
    imposed on others
annex - Append or add as an extra or subordinate part, esp. to a document
erroneous - Wrong; incorrect
conjoin - Join; combine
Join; combine
extraneous - Irrelevant or unrelated to the subject being dealt with; of
    external origin
denomination - A name or designation, esp. one serving to classify a set of things
confined - (of a space) Restricted in area or volume; cramped
abridge - Shorten (a book, movie, speech, or other text) without losing the
    sense
equilateral - Having all its sides of the same length
explication - the act of making clear or removing obscurity from the meaning of
    a word or symbol or expression etc.
recourse (noun) - A source of help in a difficult situation
inexplicable - unable to be explained or accounted for
tacit (adj) - Understood or implied without being stated
afoul (adverb) - Into conflict or difficulty with
tenet - A principle or belief, esp. one of the main principles of a religion or
    philosophy
burden - A duty or misfortune that causes hardship, anxiety, or grief; a
    nuisance
conjure - Make (something) appear unexpectedly or seemingly from nowhere as if
    by magic
tally (verb) - Agree or correspond
exhort - Strongly encourage or urge (someone) to do something
    "the general exhortation to ... doesn't spark a lot of enthusiasm"
looming - (of an event regarded as ominous or threatening) Seem about to happen
    "tenure review was looming"
stoke (verb) - Encourage or incite (a strong emotion or tendency)
    "these two properties helped the goal stoke my motivation"
incite (verb) - Encourage or stir up (violent or unlawful behavior)
vie (verb) - Compete eagerly with someone in order to do or achieve something
    "that drives them to focus on these measures, even when other demands vie
    for their attention"
visceral - Relating to deep inward feelings rather than to the intellect
spur (verb) - Give an incentive or encouragement to (someone)
    "This reality helped spur me to squeeze more such hours into each workweek"
cadence - A modulation or inflection of the voice
inflection - The modulation of intonation or pitch in the voice
endorsement - An act of giving one's public approval or support to someone or something
frenetic - Fast and energetic in a rather wild and uncontrolled way
    "his distaste for frenetic work"
insidious - Treacherous; crafty; Proceeding in a gradual, subtle way, but with
    harmful effects
treacherous - Guilty of or involving betrayal or deception
pinprick - A prick caused by a pin; a cause of minor irritation
onslaught - A fierce or destructive attack; a large quantity of people or things
    that is difficult to cope with
vice - A weakness of character or behavior; a bad habit
    "Idleness is not just a vacation, an indulgence or a vice"
rickets - A disease of children caused by vitamin D deficiency, characterized by
    imperfect calcification, softening, and distortion of the bones typically
    resulting in bow legs
buttercups - A herbaceous plant with bright yellow cup-shaped flowers, common in
    grassland and as a garden weed
replenish - fill (something) up again; restore to the former level or condition
respite (noun) - A short period of rest or relief from something difficult or
    unpleasant
scribbled - That which has been scribbled, written in a scrawled or careless
    hand
skim (verb) - Read (something) quickly or cursorily so as to note only the
    important points
muster (verb) - Collect or assemble (a number or amount)
reek (verb) - Be suggestive of something unpleasant or disapproved of
    "that reeks of a bygone millennium"
sully - Damage the purity or integrity of; defile
    "they eliminate the need for us to sully our hands with manual resource
    release"
quibble - A slight objection or criticism
    "all the arguments employ'd against the possibility of mathematical points
    are mere scholastick quibbles"
disparate - Essentially different in kind; not allowing comparison
    "rvalue references are the glue that ties these two rather disparate
    features together"
bedrock - The fundamental principles on which something is based
    "honesty is the bedrock of a good relationship"
din - A loud, unpleasant, and prolonged noise
    "lose your bearings in the din"
furnish - Supply someone with (something); give (something) to someone
    "she was able to furnish me with details of the incident"
    "every idea, with which imagination is furnish'd, first makes its appearence
    in correspondent impression"
nay (adverb) - Or rather; and more than that (used to emphasize a more
    appropriate word than one just used)
decisive - Settling an issue; producing a definite result
    "there is another very decisive argument"
corpuscle (noun) - A minute body or cell in an organism, esp. a red or white
    cell in the blood of vertebrates; A minute particle regarded as the basic
    constituent of matter or light
endowed - Provide with a quality, ability, or asset
    "he was endowed with tremendous physical strength"
clatter - A continuous rattling sound as of hard objects falling or striking
    each other; noisy rapid talk
tethers - A rope or chain with which an animal is tied to restrict its movement
gorge - Eat a large amount greedily; fill oneself with food
segregation - The action or state of setting someone or something apart from
    other people or things or being set apart
gird (verb) - Make cutting or critical remarks
    "you simply gird yourself for the temporary boredom"
mutton chops - sheep meat or a style of facial hair
brash - Strong, energetic, or irreverent
irreverent - Showing a lack of respect for people or things that are generally
    taken seriously
extracurricular - (of an activity at a school or college) Pursued in addition to
    the normal course of study
exuberance - The quality of being full of energy, excitement, and cheerfulness; ebullience
crater (verb) - Form a crater in (the ground or a planet)
    "One might expect therefore that Roosevelt's grades would crater"
recite - Repeat aloud or declaim (a poem or passage) from memory before an
    audience
discerning - Having or showing good judgment
    "... like trying to impress the always-discerning members of the Nuttall
    Ornithological Club"
dismay - Cause (someone) to feel consternation and distress
    "the city, it turns out to my dismay, is often slow to shovel the pedestrian
    path after snowstorms"
consternation - Feelings of anxiety or dismay, typically at something unexpected
rebellion - An act of violent or open resistance to an established government or
    ruler
tantalizing - Torment or tease (someone) with the sight or promise of something
    that is unobtainable
consolidate - Reinforce or strengthen (one's position or power)
rote (noun/adj) - Mechanical or habitual repetition of something to be learned
    "the rote memorizing you might remember from your school days"
pervade - (esp. of a smell) Spread through and be perceived in every part of
crude - In a natural or raw state; not yet processed or refined
    "these two choices are much too crude to be useful"
stave - Avert or delay something bad or dangerous
    "I would further wager that this user would succeed in staving off boredom
    even if the service were suddenly shut down"
eschew (verb) - Deliberately avoid using; abstain from
abstain (verb) - Restrain oneself from doing or enjoying something
revel (verb) - Enjoy oneself in a lively and noisy way, esp. with drinking and
    dancing
ergo - Therefore
finicky - Showing or requiring great attention to detail
    "Wording such a blessing is a finicky business"
conform (verb) - Comply with rules, standards, or laws
decisive - Settling an issue; producing a definite result
    "this wou'd be perfectly decisive, were there no medium betwixt the infinite
    divisibility of matter, and the non-entity of mathematical pooints"
bestow (verb) - Confer or present (an honor, right, or gift); Grant or bestow (a
    title, degree, benefit, or right)
circumference - The enclosing boundary of a curved geometric figure, esp. a
    circle; The edge or region that entirely surrounds something
infirmity - Physical or mental weakness
    "What chiefly gives rise to these‘ objections, and at the same time renders
    it so difficult to give a satisfactory answer to them is the natural
    infirmity and unsteadiness both of our imagination and senses..."
elude (verb) - Evade or escape from (a danger, enemy, or pursuer), typically in
    a skillful or cunning way; (of an idea or fact) Fail to be grasped or
    remembered by (someone)
    "Every particle eludes the grasp by a new fraction..."
quicksilver (noun) - The liquid metal mercury
cavil (verb) - Make petty or unnecessary objections
      (noun) - an objection of this kind
    "... and others eluded the force of this reasoning by a heap of
    unintelligible cavils and distinctions"
adversary - One's opponent in a contest, conflict, or dispute; The Devil (???)
    "Both these adversaries equally yield the victory"
Persephone - (Greek mythology) daughter of Zeus and Demeter; made queen of the
    underworld by Pluto in ancient mythology; identified with Roman Proserpina
topple (verb) - Overbalance or become unsteady and fall slowly
    "An easy way to topple into this pit..."
exasperation - A feeling of intense irritation or annoyance
    "your compilers will throw up their hands in exasperation..."
sworn (adj) - (of testimony or evidence) Given under oath
    "... but compilers are sworn to uphold the rules of C++"
oath - solemn promise, often invoking a divine witness, regarding one's future
    action or behavior
congruity - suitable or appropriate together; the quality of agreeing, being
    suitable and appropriate
    "There are some, who pretend, that equality is best defin'd by congruity..."
infallible - Never failing; always effective
rectitude - Morally correct behavior or thinking; righteousness
deity - A god or goddess (in a polytheistic religion); Divine status, quality,
    or nature; The creator and supreme being
beseech - Ask (someone) urgently and fervently to do something; implore; entreat
implore - Beg someone earnestly or desperately to do something
entreat - Ask someone earnestly or anxiously to do something
draught - draft; blueprint
fallacy - A mistaken belief, esp. one based on unsound argument; A failure in
    reasoning that renders an argument invalid; Faulty reasoning; misleading or
    unsound argument
funnel (noun) - A tube or pipe that is wide at the top and narrow at the bottom,
    used for guiding liquid or powder into a small opening
    (verb) - Guide or channel (something) through or as if through a funnel
morass - A complicated or confused situation
tumble - (typically of a person) Fall suddenly, clumsily, or headlong
headlong - With the head foremost
droid - A person regarded as lifeless or mechanical
fudge (verb) - Present or deal with (something) in a vague, noncommittal, or
    inadequate way, esp. so as to conceal the truth or mislead
    "I'm fudging the truth here"
belay (verb) - Stop; enough
    "belay that celebration"
pesky - causing trouble; annoying
aplomb - Self-confidence or assurance, esp. when in a demanding situation
subtile - subtle
extension - The property of occupying space; spatial magnitude
apt (adj) - Having a tendency to do something
    "wherever there is a close relation between two ideas, the mind is very apt
    to mistake them"
forbear (verb) - Politely or patiently restrain an impulse to do something;
    refrain
    "I cannot forbear stopping for a moment"
premise - An assertion or proposition which forms the basis for a work or
    theory; A previous statement or proposition from which another is inferred
    or follows as a conclusion
prosecution - The institution and conducting of legal proceedings against
    someone in respect of a criminal charge; The continuation of a course of
    action with a view to its completion
specious - Superficially plausible, but actually wrong
rummage (verb) - Search unsystematically and untidily through a mass or
    receptacle
receptacle - an object or place used to contain something
    "trash receptacles"
lieu (noun) - instead
    "the company issued additional shares to shareholders in lieu of a cash
    dividend"
overhaul - Take apart (a piece of machinery or equipment) in order to examine it
    and repair it if necessary
    "the entire C++98 Standard Library was overhauled for C++11 to add move
    operations"
plenum - A space completely filled with matter, or the whole of space so
    regarded
kinship - blood relationship; a sharing of characteristics or origins
elated - ecstatically happy
ignoble - not honorable in  character or purpose
    "the few, who think that they are formed for fidelity and modesty and a sure
    use of appearances, have no mean or ignoble thoughts about themselves"
emblazoned - conspicuously inscribe or display
salient - most noticeable or important
awry (adverb) - away from the appropriate, planned or expected course; amiss
weasel - a deceitful or treacherous person
prodigious - remarkably or impressively great in extent, size or degree;
    unnatural or abnormal
intricate - complicated or detailed
impute - represent (something, esp. undesirable) as being done, caused or
    possessed by someone; attribute
artifice - clever or cunning devices or expedients, esp. as used to trick or
    deceive others
remedy (verb) - set right (an undesirable situation)
lull (verb) - calm or send to sleep, typically with soothing sounds or
    movements
precarious - not securely held or in position; dangerously likely to fall or
    collapse
hinge (noun) - a movable joint or mechanism on which a door, gate, or lid swings
    as it opens and closes, or that connects linked objects
      (verb) - attach or join with or as if with a hinge
ascribe - attribute something to (a cause); (of a door or part of a structure)
    hangs
    "he ascribed Jane's short temper to her upset stomach"
levity - humor or frivolity, esp. the treatment of a serious matter with humor
    or in a manner lacking due respect
repose - place something, esp. one's confidence or trust, in
brevity - concise and exact use of words in writing or speech
precipitate (verb) - Cause (an event or situation, typically one that is bad or
    undesirable) to happen suddenly, unexpectedly, or prematurely
paroxysm - A sudden attack or violent expression of a particular emotion or
    activity
extemporaneous - spoken or done without preparation
pontificate - Express one's opinions in a way considered annoyingly pompous and
    dogmatic
digress - Leave the main subject temporarily in speech or writing
meek - Quiet, gentle, and easily imposed on; submissive
condescension - An attitude of patronizing superiority; disdain
patronize- Treat with an apparent kindness that betrays a feeling of
    superiority
disdain (noun) - The feeling that someone or something is unworthy of one's
    consideration or respect; contempt
rigmarole - a lengthy and complicated procedure
eavesdropping - secretly listen to a conversation
rejoice (verb) - feel or show great joy or delight
crux (noun) - the decisive or most important point at issue
fortiori (latin) - with greater reason; for a still stronger, more certain
    reason
    "... on the contrary in excluding all external causes, excludes a fortiori
    the thing itself which is created"
    "if you are wrong then, a fortiori, so am I"
frivolity - lack of seriousness; lightheartedness
proverbial - well known; stereotypical
bouillabaisse - A rich, spicy stew or soup made with various kinds of fish,
    originally from Provence
feign (verb) - pretend to be affected by (a feeling, state or injury); invent (a
    story or excuse)
obliterate - destroy utterly; wipe out
feeble - lacking physical strength; faint; failing to convince or impress
vigor - effort, energy, enthusiasm; legal or binding force, validity
assent (noun) - the expression of approval or agreement
    (verb) - the same thing
emanate (verb) - (of something abstract but perceptible) issue or spread out
    from (a source); originate from; be produced by; give out or emit
    "... the odor emanates from the need to use the mutex ..."
shoal (noun) - an area of shallow water; a hidden danger or
    difficulty
    (verb) - become shallower
    (adj) - shallow
skirt (verb) - go around or past the edge of; attempt to ignore; avoid dealing
    with
    "... a future-based approach skirts those shoals ..."
superfluous - unnecessary; more than enough
stilts - a pair of upright poles with supports for the feet enabling the user to
    walk at a distance above the ground (ходули)
foregoing - just mentioned or stated; preceding
presume - suppose that something is the case on the basis of probability; take
    for granted that something exists or is the case; be audacious enough to do
    something
audacity - the willingness to take bold risks; rude or disrespectful behaviour;
    impudence
impudent - not showing due respect for another parson; impertinent
impertinent - not showing proper respect; rude
anticipate - regard as probable; expect or predict
efficacy - the ability to produce a desired or intended result
ensue - happen or occur afterward or as result
astute (adj) - having or showing an ability to accurately assess situations or
    people and turn this to one's advantage
stray (adj) - not in the right place; not where it should be or where other
    items of the same kind are; (of a domestic animal) homeless
imbue - inspire or permeate with a feeling or quality
permeate - spread throughout (something); pervade
decree (noun) - an official order issued by legal authority
    (verb) - order (something) by decree
incredulity - the state of being unwilling or unable to believe something
wherein (adverb) - in which; in what place or respect
unintelligible - impossible to understand
confest (adj) - admitted
dissent (noun) - opposite to assent
mingle (verb) - mix or cause to mix together; move freely around a place or at a
    social function, associating with others
confer - grant or bestow (a title, degree, benefit, or right)
dwell (verb) - live in or at a specified place; think, speak or write at length
    about (a particular subject, esp. one that is a source of unhappiness,
    anxiety, or dissatisfaction)
reverie (noun) - a state of being pleasantly lost in one's thoughts; a daydream;
    a fanciful or impractical idea or theory
enmity - the state of feeling of being actively opposed or hostile to someone or
    something
superstition - excessively credulous belief in and reverence for supernatural
    beings
plead (verb) - make an emotional appeal
    "The devotees of that strange superstition usually plead in excuse of the
    mummeries ..."
    state formally in court whether one is guilty of the offence with
    which one is charged
mummer - a pantomimist
upbraid (verb) - find fault with (someone); scold
scold (verb) - remonstrate with or rebuke (someone) angrily
remonstrate - make a forcefully reproachful protest
reproachful - expressing disapproval or disappointment
fervor - intense and passionate feeling; intense heat
concur (verb) - be of the same opinion; agree
abundant - existing of available in large quantities; plentiful
procure - obtain (something), esp. with car or effort; obtain (someone) as a
    prostitute for another person
procurer - sutener koroche
relic - an object surviving from an earlier time, esp. one of historical or
    sentimental interest; a part of a deceased holy person's body or belongings kept
    as an object of reverence
oblique - neither parallel nor at a right angle to a specified or implied line;
    slanting; not explicit or direct in addressing a point
slanting - positioned or directed in a sloping or oblique direction
propriety - the state or quality of conforming to conventionally accepted
    standards of behaviour or morals; the details or rules of behaviour
    conventionally considered to be correct
delineate - describe or portray (something) precisely
je ne sais quoi - something (such as an appealing quality) that cannot be
    adequately described or expressed
chafe (verb) - (of something restrictive or too tight) make (a part of the body)
    sore by rubbing against it; (of a part of the body) be or become sore as a
    result of such rubbing; become or make annoyed or impatient because of a
    restriction or inconvenience
frenzy - a state or period of uncontrolled excitement or wild behaviour
sanguine - cheerfully optimistic
upshot - the final or eventual outcome or conclusion of a discussion, action, or
    series of events
treading, trod, trodden (verb) - walk in a specified way; walk on or along
curfew - комендантский час


