Suffice to say - "скажу лишь, ..."
Be that as it may
So be it
Come what may
Which was when - тогда и ... (тогда я и открыл для себя свой талант)
Snap decision - срочное решение
Strike while the iron is hot
to be bowled over - быть сбитым с толку
what sets it apart from smth - что отличает его от чего-то, так это...
to all intents and purposes - фактически, почти полностью
    "Notice how people insert the ‘Mr.’ before sinking the blade in?"
jingles and chimes - очев
to great lengths - на многое: "every family goes to great lengths to hide ugly truths"
for all its good [in the political arena]
to strip smth of smth:
    this thinking stripped the world of the order and sacredness
fire and brimstone - The punishment of hell
tall order - a formidable task or requirement
too far afield
suffice to say - in short, in summary; it is enough to say
    "I won't go into the details of our conversation, but suffice it to say that
    Bob won't be coming back on Monday."
run of the mill - not outstanding in quality or rarity; AVERAGE, ORDINARY
cause and effect - причина и следствие
by long custom - по давнему обычаю
isn't worth a trouble
net effect - The final result when all the pluses and minuses, all the gains and losses, have been taken into account.
to be fraught with smth - полно чего-то (у компании полно проблем)
smth is about to go under - что-то идёт ко дну (компания вот-вот обанкротится)
to indulge in smth - предаться чему-то
to indulge yourself with smth - побаловать себя чем-то
off the beaten track - away from main roads, centres of population etc.      
the back of beyond - extremely remote location
set apart some time - выделить немного времени
on a shoestring - on a tight budget
far cry (from) - something notably different
the old chestnut - a joke, story, or subject that has become tedious and uninteresting through constant repetition
(smth) filtered down to (smth) - что-то просочилось в что-то
bound to do something - you have no choice but to do 'something'
in and of itself - само по себе
lose (one's) bearings - to lose sight of or become unable to determine one's
    orientation
count your blessings - To reflect on the good things in one's life and be
    grateful for them.
one-off - done, made or happening only once and not repeated
the best of a bad lot - меньшее из зол
walk on eggshells - to be very careful not to offend or upset someone
can't make an omelette without breaking a few eggs - суть понятна, но есть один
    интересный аналог в русском "лес рубят - щепки летят"
